"filename", "language", "HTML", "CSS", "XML", "JSON", "JavaScript", "comment", "blank", "total"
"/Users/mazalov/Desktop/ПрагматикаЮГ/PragmaticUg/src/about.html", "HTML", 23, 0, 0, 0, 0, 1, 0, 24
"/Users/mazalov/Desktop/ПрагматикаЮГ/PragmaticUg/src/assets/icons/gerbs/Bashkortostan.svg", "XML", 0, 0, 52, 0, 0, 0, 1, 53
"/Users/mazalov/Desktop/ПрагматикаЮГ/PragmaticUg/src/assets/icons/gerbs/Crimea.svg", "XML", 0, 0, 78, 0, 0, 0, 1, 79
"/Users/mazalov/Desktop/ПрагматикаЮГ/PragmaticUg/src/assets/icons/gerbs/Donetsk_Peoples_Republic.svg", "XML", 0, 0, 278, 0, 0, 0, 1, 279
"/Users/mazalov/Desktop/ПрагматикаЮГ/PragmaticUg/src/assets/icons/gerbs/Kaliningrad_Oblast.svg", "XML", 0, 0, 21, 0, 0, 0, 1, 22
"/Users/mazalov/Desktop/ПрагматикаЮГ/PragmaticUg/src/assets/icons/gerbs/Leningrad_Oblast.svg", "XML", 0, 0, 52, 0, 0, 0, 1, 53
"/Users/mazalov/Desktop/ПрагматикаЮГ/PragmaticUg/src/assets/icons/gerbs/Lugansk_People_Republic.svg", "XML", 0, 0, 878, 0, 0, 0, 1, 879
"/Users/mazalov/Desktop/ПрагматикаЮГ/PragmaticUg/src/assets/icons/gerbs/Primorsky_Krai.svg", "XML", 0, 0, 55, 0, 0, 0, 1, 56
"/Users/mazalov/Desktop/ПрагматикаЮГ/PragmaticUg/src/assets/icons/gerbs/Rostov_Oblast.svg", "XML", 0, 0, 2147, 0, 0, 0, 1, 2148
"/Users/mazalov/Desktop/ПрагматикаЮГ/PragmaticUg/src/assets/icons/gerbs/Saint_Petersburg.svg", "XML", 0, 0, 1484, 0, 0, 0, 1, 1485
"/Users/mazalov/Desktop/ПрагматикаЮГ/PragmaticUg/src/assets/icons/gerbs/Sakhalin_Oblast.svg", "XML", 0, 0, 33, 0, 0, 0, 1, 34
"/Users/mazalov/Desktop/ПрагматикаЮГ/PragmaticUg/src/assets/icons/gerbs/Sverdlovsk_oblast.svg", "XML", 0, 0, 214, 0, 0, 0, 1, 215
"/Users/mazalov/Desktop/ПрагматикаЮГ/PragmaticUg/src/assets/images/preloader/Logo.svg", "XML", 0, 0, 23, 0, 0, 0, 1, 24
"/Users/mazalov/Desktop/ПрагматикаЮГ/PragmaticUg/src/assets/images/preloader/big_opaciti_logo.svg", "XML", 0, 0, 13, 0, 0, 0, 1, 14
"/Users/mazalov/Desktop/ПрагматикаЮГ/PragmaticUg/src/blocks/about/about-review/about-review.css", "CSS", 0, 4, 0, 0, 0, 0, 3, 7
"/Users/mazalov/Desktop/ПрагматикаЮГ/PragmaticUg/src/blocks/about/about.css", "CSS", 0, 16, 0, 0, 0, 0, 2, 18
"/Users/mazalov/Desktop/ПрагматикаЮГ/PragmaticUg/src/blocks/contacts/contacts.css", "CSS", 0, 3, 0, 0, 0, 0, 2, 5
"/Users/mazalov/Desktop/ПрагматикаЮГ/PragmaticUg/src/blocks/forms/contact-cta.css", "CSS", 0, 0, 0, 0, 0, 0, 1, 1
"/Users/mazalov/Desktop/ПрагматикаЮГ/PragmaticUg/src/blocks/index/1.start-section/start-section.css", "CSS", 0, 0, 0, 0, 0, 0, 1, 1
"/Users/mazalov/Desktop/ПрагматикаЮГ/PragmaticUg/src/blocks/index/2.popular-product/slider.css", "CSS", 0, 2, 0, 0, 0, 0, -2, 0
"/Users/mazalov/Desktop/ПрагматикаЮГ/PragmaticUg/src/blocks/index/5.change-color-section/change-color-section.css", "CSS", 0, 1, 0, 0, 0, 0, 0, 1
"/Users/mazalov/Desktop/ПрагматикаЮГ/PragmaticUg/src/blocks/index/index.css", "CSS", 0, 1, 0, 0, 0, 0, 0, 1
"/Users/mazalov/Desktop/ПрагматикаЮГ/PragmaticUg/src/blocks/index/preloader/preloader.css", "CSS", 0, 67, 0, 0, 0, 3, 10, 80
"/Users/mazalov/Desktop/ПрагматикаЮГ/PragmaticUg/src/blocks/nskSystem/nskSystem.css", "CSS", 0, 44, 0, 0, 0, 0, 9, 53
"/Users/mazalov/Desktop/ПрагматикаЮГ/PragmaticUg/src/blocks/obratnaya-svyaz/obratnaya-svyaz.css", "CSS", 0, 121, 0, 0, 0, 9, 20, 150
"/Users/mazalov/Desktop/ПрагматикаЮГ/PragmaticUg/src/blocks/partners/partners.css", "CSS", 0, 52, 0, 0, 0, 0, 9, 61
"/Users/mazalov/Desktop/ПрагматикаЮГ/PragmaticUg/src/blocks/popup/popup.css", "CSS", 0, 35, 0, 0, 0, 3, 5, 43
"/Users/mazalov/Desktop/ПрагматикаЮГ/PragmaticUg/src/blocks/product-template/description/product-consumption.css", "CSS", 0, 1, 0, 0, 0, 0, 0, 1
"/Users/mazalov/Desktop/ПрагматикаЮГ/PragmaticUg/src/blocks/ralClassic/ralClassic.css", "CSS", 0, 6, 0, 0, 0, 0, 1, 7
"/Users/mazalov/Desktop/ПрагматикаЮГ/PragmaticUg/src/blocks/tekc/tekc.css", "CSS", 0, 2, 0, 0, 0, 0, 1, 3
"/Users/mazalov/Desktop/ПрагматикаЮГ/PragmaticUg/src/blocks/tekc/tekcexterior/tekcexterior.css", "CSS", 0, 0, 0, 0, 0, 0, 1, 1
"/Users/mazalov/Desktop/ПрагматикаЮГ/PragmaticUg/src/blocks/tekc/tekcinterior/tekcinterior.css", "CSS", 0, 19, 0, 0, 0, 0, 4, 23
"/Users/mazalov/Desktop/ПрагматикаЮГ/PragmaticUg/src/blocks/tikkurilasymphony/tikkurilasymphony.css", "CSS", 0, 16, 0, 0, 0, 0, 3, 19
"/Users/mazalov/Desktop/ПрагматикаЮГ/PragmaticUg/src/catalog.html", "HTML", 15, 0, 0, 0, 0, 0, -1, 14
"/Users/mazalov/Desktop/ПрагматикаЮГ/PragmaticUg/src/certification.html", "HTML", 1, 0, 0, 0, 0, 0, -1, 0
"/Users/mazalov/Desktop/ПрагматикаЮГ/PragmaticUg/src/color_collections.html", "HTML", 27, 0, 0, 0, 0, 0, -1, 26
"/Users/mazalov/Desktop/ПрагматикаЮГ/PragmaticUg/src/contacts.html", "HTML", 28, 0, 0, 0, 0, 0, -1, 27
"/Users/mazalov/Desktop/ПрагматикаЮГ/PragmaticUg/src/data/data-catalog-color/nsk.json", "JSON", 0, 0, 0, 8136, 0, 0, 0, 8136
"/Users/mazalov/Desktop/ПрагматикаЮГ/PragmaticUg/src/data/data-catalog-color/tekcInterior.json", "JSON", 0, 0, 0, 31403, 0, 0, 1, 31404
"/Users/mazalov/Desktop/ПрагматикаЮГ/PragmaticUg/src/data/data-catalog-color/tekc_ Exterior.json", "JSON", 0, 0, 0, -4646, 0, 0, -1, -4647
"/Users/mazalov/Desktop/ПрагматикаЮГ/PragmaticUg/src/data/data-catalog-color/tekc_ Interior.json", "JSON", 0, 0, 0, -31403, 0, 0, -1, -31404
"/Users/mazalov/Desktop/ПрагматикаЮГ/PragmaticUg/src/data/data-catalog-color/tekcexterior.json", "JSON", 0, 0, 0, 4646, 0, 0, 1, 4647
"/Users/mazalov/Desktop/ПрагматикаЮГ/PragmaticUg/src/data/data-catalog-color/tikkurila_symphony.json", "JSON", 0, 0, 0, 2151, 0, 0, 0, 2151
"/Users/mazalov/Desktop/ПрагматикаЮГ/PragmaticUg/src/data/data-change-color.json", "JSON", 0, 0, 0, 4, 0, 0, 0, 4
"/Users/mazalov/Desktop/ПрагматикаЮГ/PragmaticUg/src/duluxCr5.html", "HTML", 22, 0, 0, 0, 0, 0, -1, 21
"/Users/mazalov/Desktop/ПрагматикаЮГ/PragmaticUg/src/index.html", "HTML", -94, 0, 0, 0, 0, 33, -19, -80
"/Users/mazalov/Desktop/ПрагматикаЮГ/PragmaticUg/src/nskSystem.html", "HTML", 1507, 0, 0, 0, 0, 12, 28, 1547
"/Users/mazalov/Desktop/ПрагматикаЮГ/PragmaticUg/src/obratnaya-svyaz.html", "HTML", 581, 0, 0, 0, 0, 18, 29, 628
"/Users/mazalov/Desktop/ПрагматикаЮГ/PragmaticUg/src/partners.html", "HTML", 1437, 0, 0, 0, 0, 0, 0, 1437
"/Users/mazalov/Desktop/ПрагматикаЮГ/PragmaticUg/src/product-template.html", "HTML", 15, 0, 0, 0, 0, 0, -1, 14
"/Users/mazalov/Desktop/ПрагматикаЮГ/PragmaticUg/src/ralClassic.html", "HTML", 20, 0, 0, 0, 0, 0, -1, 19
"/Users/mazalov/Desktop/ПрагматикаЮГ/PragmaticUg/src/scripts/about/about.js", "JavaScript", 0, 0, 0, 0, 1, 0, 0, 1
"/Users/mazalov/Desktop/ПрагматикаЮГ/PragmaticUg/src/scripts/about/review/review.js", "JavaScript", 0, 0, 0, 0, -1, 1, 0, 0
"/Users/mazalov/Desktop/ПрагматикаЮГ/PragmaticUg/src/scripts/catalog/app.js", "JavaScript", 0, 0, 0, 0, 9, -1, 0, 8
"/Users/mazalov/Desktop/ПрагматикаЮГ/PragmaticUg/src/scripts/catalog/filters.js", "JavaScript", 0, 0, 0, 0, 15, 4, 3, 22
"/Users/mazalov/Desktop/ПрагматикаЮГ/PragmaticUg/src/scripts/color_collections/color_collections.js", "JavaScript", 0, 0, 0, 0, 12, 0, 4, 16
"/Users/mazalov/Desktop/ПрагматикаЮГ/PragmaticUg/src/scripts/modal/modal.js", "JavaScript", 0, 0, 0, 0, 22, 7, 7, 36
"/Users/mazalov/Desktop/ПрагматикаЮГ/PragmaticUg/src/scripts/nskSystem/nskSystem.js", "JavaScript", 0, 0, 0, 0, 7, 0, 4, 11
"/Users/mazalov/Desktop/ПрагматикаЮГ/PragmaticUg/src/scripts/obratnaya-svyaz/obratnaya-svyaz.js", "JavaScript", 0, 0, 0, 0, 41, 6, 7, 54
"/Users/mazalov/Desktop/ПрагматикаЮГ/PragmaticUg/src/scripts/start-page/5.change-color-section.js", "JavaScript", 0, 0, 0, 0, 4, -4, 0, 0
"/Users/mazalov/Desktop/ПрагматикаЮГ/PragmaticUg/src/scripts/start-page/index.js", "JavaScript", 0, 0, 0, 0, 50, 5, 11, 66
"/Users/mazalov/Desktop/ПрагматикаЮГ/PragmaticUg/src/scripts/tekc/tekcexterior.js", "JavaScript", 0, 0, 0, 0, 7, 0, 2, 9
"/Users/mazalov/Desktop/ПрагматикаЮГ/PragmaticUg/src/scripts/tekc/tekcinterior.js", "JavaScript", 0, 0, 0, 0, 7, 0, 3, 10
"/Users/mazalov/Desktop/ПрагматикаЮГ/PragmaticUg/src/scripts/tikkurilasymphony/tikkurilasymphony.js", "JavaScript", 0, 0, 0, 0, 7, 0, 3, 10
"/Users/mazalov/Desktop/ПрагматикаЮГ/PragmaticUg/src/styles/styles.css", "CSS", 0, 5, 0, 0, 0, 0, 0, 5
"/Users/mazalov/Desktop/ПрагматикаЮГ/PragmaticUg/src/tekcexterior.html", "HTML", 618, 0, 0, 0, 0, 12, 27, 657
"/Users/mazalov/Desktop/ПрагматикаЮГ/PragmaticUg/src/tekcinterior.html", "HTML", 619, 0, 0, 0, 0, 12, 27, 658
"/Users/mazalov/Desktop/ПрагматикаЮГ/PragmaticUg/src/tikkurilasymphony.html", "HTML", 610, 0, 0, 0, 0, 12, 27, 649
"Total", "-", 5429, 395, 5328, 10291, 181, 133, 239, 21996