"filename", "language", "XML", "HTML", "CSS", "JSON", "JavaScript", "comment", "blank", "total"
"/Users/mazalov/Desktop/ПрагматикаЮГ/PragmaticUg/src/about.html", "HTML", 0, 436, 0, 0, 0, 1, 1, 438
"/Users/mazalov/Desktop/ПрагматикаЮГ/PragmaticUg/src/assets/images/Gatchinskiy.svg", "XML", 12, 0, 0, 0, 0, 0, 1, 13
"/Users/mazalov/Desktop/ПрагматикаЮГ/PragmaticUg/src/assets/images/mapLO.svg", "XML", 58, 0, 0, 0, 0, 0, 1, 59
"/Users/mazalov/Desktop/ПрагматикаЮГ/PragmaticUg/src/blocks/about/about-advantages/about-advantages.css", "CSS", 0, 0, 63, 0, 0, 4, 7, 74
"/Users/mazalov/Desktop/ПрагматикаЮГ/PragmaticUg/src/blocks/about/about-img/about-img.css", "CSS", 0, 0, 32, 0, 0, 0, 5, 37
"/Users/mazalov/Desktop/ПрагматикаЮГ/PragmaticUg/src/blocks/about/about-mission/about-mission.css", "CSS", 0, 0, 38, 0, 0, 0, 8, 46
"/Users/mazalov/Desktop/ПрагматикаЮГ/PragmaticUg/src/blocks/about/about-production/about-production.css", "CSS", 0, 0, 34, 0, 0, 0, 6, 40
"/Users/mazalov/Desktop/ПрагматикаЮГ/PragmaticUg/src/blocks/about/about-review/about-review.css", "CSS", 0, 0, 78, 0, 0, 0, 13, 91
"/Users/mazalov/Desktop/ПрагматикаЮГ/PragmaticUg/src/blocks/about/about.css", "CSS", 0, 0, 65, 0, 0, 0, 10, 75
"/Users/mazalov/Desktop/ПрагматикаЮГ/PragmaticUg/src/blocks/button/button-up.css", "CSS", 0, 0, 18, 0, 0, 0, 2, 20
"/Users/mazalov/Desktop/ПрагматикаЮГ/PragmaticUg/src/blocks/button/button.css", "CSS", 0, 0, 1, 0, 0, 0, 0, 1
"/Users/mazalov/Desktop/ПрагматикаЮГ/PragmaticUg/src/blocks/color_collections/color_collections.css", "CSS", 0, 0, 75, 0, 0, 0, 14, 89
"/Users/mazalov/Desktop/ПрагматикаЮГ/PragmaticUg/src/blocks/contacts/contacts.css", "CSS", 0, 0, 16, 0, 0, -3, 3, 16
"/Users/mazalov/Desktop/ПрагматикаЮГ/PragmaticUg/src/blocks/duluxCr5/duluxCr5.css", "CSS", 0, 0, 110, 0, 0, 7, 20, 137
"/Users/mazalov/Desktop/ПрагматикаЮГ/PragmaticUg/src/blocks/header/header.css", "CSS", 0, 0, 1, 0, 0, 0, 0, 1
"/Users/mazalov/Desktop/ПрагматикаЮГ/PragmaticUg/src/blocks/index/1.start-section/start-section.css", "CSS", 0, 0, 0, 0, 0, 0, 1, 1
"/Users/mazalov/Desktop/ПрагматикаЮГ/PragmaticUg/src/blocks/partners/partners.css", "CSS", 0, 0, 1, 0, 0, 0, 0, 1
"/Users/mazalov/Desktop/ПрагматикаЮГ/PragmaticUg/src/blocks/product-template/description/description.css", "CSS", 0, 0, 0, 0, 0, 0, -2, -2
"/Users/mazalov/Desktop/ПрагматикаЮГ/PragmaticUg/src/blocks/product-template/description/updatePrice.css", "CSS", 0, 0, 21, 0, 0, 1, 3, 25
"/Users/mazalov/Desktop/ПрагматикаЮГ/PragmaticUg/src/blocks/ralClassic/filters/filters-container.css", "CSS", 0, 0, 30, 0, 0, 0, 4, 34
"/Users/mazalov/Desktop/ПрагматикаЮГ/PragmaticUg/src/blocks/ralClassic/ralClassic.css", "CSS", 0, 0, 19, 0, 0, 0, 5, 24
"/Users/mazalov/Desktop/ПрагматикаЮГ/PragmaticUg/src/blocks/universal-function/universal-function.css", "CSS", 0, 0, 64, 0, 0, 0, 10, 74
"/Users/mazalov/Desktop/ПрагматикаЮГ/PragmaticUg/src/catalog.html", "HTML", 0, 10, 0, 0, 0, 0, 2, 12
"/Users/mazalov/Desktop/ПрагматикаЮГ/PragmaticUg/src/certification.html", "HTML", 0, 14, 0, 0, 0, 0, 1, 15
"/Users/mazalov/Desktop/ПрагматикаЮГ/PragmaticUg/src/color_collections.html", "HTML", 0, 6042, 0, 0, 0, 12, 25, 6079
"/Users/mazalov/Desktop/ПрагматикаЮГ/PragmaticUg/src/contacts.html", "HTML", 0, 36, 0, 0, 0, 0, 0, 36
"/Users/mazalov/Desktop/ПрагматикаЮГ/PragmaticUg/src/data/data-catalog-color/dulux_CP5.json", "JSON", 0, 0, 0, 18713, 0, 0, 1, 18714
"/Users/mazalov/Desktop/ПрагматикаЮГ/PragmaticUg/src/data/data-catalog-color/nsk.json", "JSON", 0, 0, 0, 11684, 0, 0, 1, 11685
"/Users/mazalov/Desktop/ПрагматикаЮГ/PragmaticUg/src/data/data-catalog-color/ral_classic.json", "JSON", 0, 0, 0, 1946, 0, 0, 1, 1947
"/Users/mazalov/Desktop/ПрагматикаЮГ/PragmaticUg/src/data/data-catalog-color/tekc_ Exterior.json", "JSON", 0, 0, 0, 4646, 0, 0, 1, 4647
"/Users/mazalov/Desktop/ПрагматикаЮГ/PragmaticUg/src/data/data-catalog-color/tekc_ Interior.json", "JSON", 0, 0, 0, 31403, 0, 0, 1, 31404
"/Users/mazalov/Desktop/ПрагматикаЮГ/PragmaticUg/src/data/data-catalog-color/tikkurila_symphony.json", "JSON", 0, 0, 0, 19865, 0, 0, 1, 19866
"/Users/mazalov/Desktop/ПрагматикаЮГ/PragmaticUg/src/data/data-images-review.json", "JSON", 0, 0, 0, 28, 0, 0, 1, 29
"/Users/mazalov/Desktop/ПрагматикаЮГ/PragmaticUg/src/data/data-review.json", "JSON", 0, 0, 0, 52, 0, 0, 1, 53
"/Users/mazalov/Desktop/ПрагматикаЮГ/PragmaticUg/src/duluxCr5.html", "HTML", 0, 1018, 0, 0, 0, 15, 29, 1062
"/Users/mazalov/Desktop/ПрагматикаЮГ/PragmaticUg/src/index.html", "HTML", 0, 12, 0, 0, 0, 0, -1, 11
"/Users/mazalov/Desktop/ПрагматикаЮГ/PragmaticUg/src/partners.html", "HTML", 0, 14, 0, 0, 0, 0, 1, 15
"/Users/mazalov/Desktop/ПрагматикаЮГ/PragmaticUg/src/product-template.html", "HTML", 0, -2, 0, 0, 0, 50, 4, 52
"/Users/mazalov/Desktop/ПрагматикаЮГ/PragmaticUg/src/ralClassic.html", "HTML", 0, 626, 0, 0, 0, 12, 30, 668
"/Users/mazalov/Desktop/ПрагматикаЮГ/PragmaticUg/src/scripts/about/about-img/about-img.js", "JavaScript", 0, 0, 0, 0, 35, 3, 14, 52
"/Users/mazalov/Desktop/ПрагматикаЮГ/PragmaticUg/src/scripts/about/about.js", "JavaScript", 0, 0, 0, 0, 57, 13, 14, 84
"/Users/mazalov/Desktop/ПрагматикаЮГ/PragmaticUg/src/scripts/about/review/review.js", "JavaScript", 0, 0, 0, 0, 30, 10, 12, 52
"/Users/mazalov/Desktop/ПрагматикаЮГ/PragmaticUg/src/scripts/catalog/catalog.js", "JavaScript", 0, 0, 0, 0, 0, 0, 1, 1
"/Users/mazalov/Desktop/ПрагматикаЮГ/PragmaticUg/src/scripts/color_collections/color_collections.js", "JavaScript", 0, 0, 0, 0, 6, 0, 4, 10
"/Users/mazalov/Desktop/ПрагматикаЮГ/PragmaticUg/src/scripts/duluxCr5/duluxCr5.js", "JavaScript", 0, 0, 0, 0, 34, 0, 5, 39
"/Users/mazalov/Desktop/ПрагматикаЮГ/PragmaticUg/src/scripts/product-template/asd.html", "HTML", 0, -1, 0, 0, 0, 0, 0, -1
"/Users/mazalov/Desktop/ПрагматикаЮГ/PragmaticUg/src/scripts/product-template/description/updatePrice.js", "JavaScript", 0, 0, 0, 0, 19, 0, 4, 23
"/Users/mazalov/Desktop/ПрагматикаЮГ/PragmaticUg/src/scripts/ralClassic/ralClassic.js", "JavaScript", 0, 0, 0, 0, 6, 0, 3, 9
"/Users/mazalov/Desktop/ПрагматикаЮГ/PragmaticUg/src/scripts/universal-function/colorCatalog.js", "JavaScript", 0, 0, 0, 0, 143, 31, 37, 211
"/Users/mazalov/Desktop/ПрагматикаЮГ/PragmaticUg/src/styles/global.css", "CSS", 0, 0, 3, 0, 0, 0, 0, 3
"/Users/mazalov/Desktop/ПрагматикаЮГ/PragmaticUg/src/styles/styles.css", "CSS", 0, 0, 8, 0, 0, 0, 2, 10
"/Users/mazalov/Desktop/ПрагматикаЮГ/PragmaticUg/src/styles/variables.css", "CSS", 0, 0, 1, 0, 0, 1, 0, 2
"Total", "-", 70, 8205, 678, 88337, 330, 157, 307, 98084